10
S.........
.##...##..
..##..#.#.
.#..##.#..
....#..##.
.###..#.##
.#..#...#.
.#..##.#..
...#....#.
.....#...G
